..................................--
....---...........................--
.........-........................--
...........---..............--....--
.......---............---.........--
.....-...........---..............--
....--.......---..........---.....--
...---.....-......................--
------------------------------------
------------------------------------